XXXXXXXXXXXXXXX
X   *     *   X
X       *     X
X     *       X
X  *  *  *    X
X             X
X     **  *   X
X             X
X  *  *  *    X
X     *       X
X     *       X
X     *   O   X
XXXXXXXXXXXXXXX

