*** *** *** *** *** ***
 *  *    *  * *  *  *  
 *  **   *  **   *  ***
 *  *    *  * *  *    *
 *  ***  *  * * *** ***
